.....#................
.....#................
......................
.e..##...#.....###..##
#####...##..e..#.#..#.
#.@......#..##.....##.
######################