.....#................
.....#................
......................
....##...#.....###..##
#####...##.....#.#..#.
#.@......#..##.....##.
######################